1011111101110111011111101111111001111011111011011110110011111111100101110110111110101110111011110011
1100111111110111010011110101111101111110110111111110111001101111110000111101111101111011111100111000
1111010111111111111111101111110111110011111111111111110101111100100111010110111101110011101111100011
1111111011111011011111111110111110111011111101111110011010011101011111101111110110111011011111111100
1111110111111111111001111111111101011101111011011111110110011011111111111111111111111111001110011111
1111111111111010111111011111101111100111111111111111011111111100111111111101111000110001111101010101
1111111110110101110110111011111011111110111110111111111111111111111111111111111111111011011111111011
1110110111110111110110111011111111110011101111111111110101101111101111111111110111111111011001111111
1011111001111111101000011110111100111101111110111111111011001100111111101111010011111111110111011111
1110111111010111010100111101111011111011110010111111111110111101111111111110111101010011101010101111
1111111111000111101111011011111111011111101101001111001110110111111100111111110111111101011111011101
1011111111110101101101110111111111011111011111010111111111110010101111111111110011111100111111111101
1111101011111101111100111111110111101011111010101111110111110111111111111111110110111101110011101111
1110111100111100001111111111111111111111111111101101111010110100101011110111110011111101010111111001
1101111110111111111100111101111111111011100011111110110100110111111111111011111111111101111101101110
1111101101101101011111110111111111110111101011111111011110111011101111111101110101111110101101100111
1111110111110001011000111111110111111100001110010001011111100101111101111111100111110110111111111101
1000011101111111101110110111111011001111101111110011001111111111111110110101110111111110110101011110
0101111011010011111111111111001011110111111111111111111110101111111101111011111010111111101110010111
1011010100011101111110001110111011111111011111001111110111111111111001111101111111101111111101111010
1101111111111110111110111111110011111111111011111111010111111101101111111111111111111101111111111000
0111010111101111111111100110101101110111111100111001111111111011011101011111111111110011111101100111
0011111111010001111111111010111110111110101101111011011011111111110111101111111111110100111101111101
1111101111110111011111111101011111111111101101101111111111111111101111111101111111011111011011101111
1111111110111111111111101001101101111111110111001110101101111111101101110111110111110001110111111101
1111111111110111101011111011011111100111110001011110111101110111101111111111111111111111011011011111
1111111111111111010101010110111011111111111110101110111111111111101111011111111011111111011010110111
1111011101010111111011111111110111111100110111110110111101101110111110110011111101111100111111101101
1110111111110101110101101111101111011111111111101111101111111000011011111101111011111111110111101111
1111111111111111000110100011111101111111111111111110111011111101111111111001111001111101101010001111
0111111111011111101111100111111110011011111111111111011011111111111110111111111111111110111111011111
1111110111101011111011011111111111011111111111100111001111110111111111110100101100111111011011111111
1111011111111110110101010111111111110011111111111110101110111111111111011011111011011100110110111110
1111110111010111101101101111010110111011101111111110111111110111110111111111111101111111010111011010
1011111111101111111111111110001111001110110101011110100111110110111101110101111111110011111111111101
1111001111011111011011101111101111100011011011011111111011111110111011001111111011110010111100101010
1111101111011111111101111111100111111111111011110111111011111111110111111000110101011111111111001011
1011111011101111111111111101111011001010111011011000101111111011111011111101111111111111101101011101
1101110101111111011111011010110111111101101101111101111111111111111101100111001111111011111100110101
1111111011101011110111110111111001111110100010101101101111110101111011111110111110111111111110101111
0111010111001111111101000011011011111011111111111011101111111100110111111111011111111111101110111101
1111110111101011111111110101110110011101111011111011111101101111111111011111011111111001111111101111
1011111111010110111111011101111111011110011111111111111011111111111111111111111101011110111110111011
1111111111111101100011010101111111100111011111011110110101111011111011111111101110111111011111111111
1011111011011111101110111101011011011111110110110110111111111111111101110111111110111111101010111101
1111010111100111011111111111100010111110101111111111101111111111111110111110111111111111010111111110
0110011111011111001111101101111101101011111111111110101101111010111111111111011111111111111111101111
0111011011111111111111111111111001011111111000011001011111001111111011011111101001111111111111111111
1111111111110111111111110110111111111110011110111111010111111110101111111111011111101101111111111111
1111110011001011101110111111101111101111101110111111110111111111111110111111111111111111011111110111
