1111011101
1111001111
1100111101
1111100101
1101011111
1111011110
1111111111
1011110111
1111001101
1111111011
