1111111111
1011111011
0101100101
1110100111
1111101011
0110111011
1111101111
1111111011
1111111111
1011101110
