01111110111010111111
11011010011011011111
00111101111101111010
11111111111111111111
00010101111001111111
10001110101011101111
11111111110101111111
11111111111001101011
00001111101101111011
11010001111111111111
01111111010100111110
10111110011110011111
11111111111101111110
01101001111111101010
00111111111101111111
11111001111111111001
00111110111111111111
11111111110111110011
01111101110111111111
10101111101111100111
01101111111111111111
11111111110011111111
11101110101101011011
01111111101010010101
11111111110111101001
11110111011111011111
11101101111111100111
01011101110111110111
11011110111111101111
11010100110111011111
11111101101101011100
11011110111110011111
11111111111010111011
11101011111111110111
10110111101110111010
11111101101111110111
01110111111110110110
11111111111111111111
01011111111111110100
11101111101011110111
11001011111001111001
11010111010100111111
11111111111111111101
11111111111111101111
11111101110111111111
11101111011111101001
01111111111111010111
10011111111111010111
01111111111111111111
11111111111111111101
