10111111111111111101
11100111110110111111
00110010011101111111
01111111111011011111
11011111111011111111
11100110111111110001
11111111010111110111
10101111101111111111
11011110111111111111
11111111101101011111
11111111011101101110
01111111111101011111
10101110011011101111
11111111110111111100
11110111111011111101
10111111101010111111
11111101110011111111
11111011011111111101
01110101111111111011
11101111111011011111
01110111101111011111
11100101111011111111
11111011111111110110
11110011110011101111
10110111111001010111
11111110111110111111
11111111011111111101
11011110011100011111
11111110101101110111
11110000011101011101
11110010111111101111
10111011110100111111
11111111101110001110
11011111110111111110
11101011001011010111
11111111110011011111
11111111111011111111
11100111111111111011
11101111111111111011
01100111101111101101
10111010110010111110
11111111101111010111
11111111111011011101
11111110110111111001
00011101111010110111
11011110111110010110
01011111111111111011
11111110101111011101
10011101011111111101
11110101111010111111
